##########
#S.......#
#.#.#####.#
#.#.#...#.#
#.#.#.#.#.#
#...#.#.E.#
##########