1111111111
1S00000001
1011111101
1010000101
1010110101
1000100001
11111111E1
