11111111111111111111
1S000001000000000001
11111011011111111101
10000010010000000101
10111110111111110101
10100000000000010101
10101111111111010101
10101000000001000001
10101111101111011111
100000000000000000E1
11111111111111111111
