####################
#S........#........#
#.########.#.#######
#.#......#.#.#.....#
#.#.####.#.#.#.###.#
#.#.#..#.#.#.#.#.#.#
#...#..#...#...#.#.#
#####.########.###.#
#...#.#......#...#.#
#.#.#.#.####.#.#.#.#
#.#.#...#..#.#.#...#
#.#####.##.#.#####.#
#.....#....#.......#
####.#####.#######.#
#....#...#.#.....#.#
#.####.#.#.#####.#.#
#.#....#.#.......#.#
#.######.#########.#
#..................E#
####################